1111111111111111111111111111111111111111111111
1P00000000000000000N0000000000000000000000N001
10000010000100001000C1000000000011111111100001
10000010C0010000100001000C000000100C00C0000001
100000100001000010C0010000C0000011111111100001
10000010C0010N001000C1000000000000C000C0100001
1000001111110000111111000C00000011111111100001
100N0000000000000000000000000C0000000000000E01
1111111111111111111111111111111111111111111111